5
W.G.-.-.-
-.-.-.-.W
P.-.-.-.G
-.-.G.G.-
-.W.W.W.-
