6
-.-.W.-.-.-
-.-.-.-.-.-
-.P.-.-.-.-
-.-.-.-.-.P
-.-.-.-.-.-
-.-.-.-.G.-
