10
-.-.P.-.P.P.-.-.-.-
-.-.-.-.G.P.-.-.P.-
-.G.-.-.-.-.-.P.-.-
-.-.-.-.P.P.-.-.-.P
-.-.-.P.-.-.-.-.-.-
G.-.G.-.P.-.-.-.P.-
P.-.P.-.-.-.-.-.-.-
-.P.G.G.G.-.G.P.P.-
P.-.-.-.-.-.W.-.P.P
-.G.-.-.-.-.-.-.-.G
