10
P.P.-.-.-.-.-.P.-.P
-.-.P.-.-.-.-.-.-.-
P.-.-.-.-.-.P.-.-.-
-.-.-.P.P.-.P.P.P.P
P.P.-.-.P.-.-.-.-.-
P.-.-.-.-.-.-.-.-.-
-.-.-.-.-.-.-.-.-.-
-.P.-.P.G.-.-.P.-.W
-.-.-.-.-.-.-.P.-.-
-.-.-.-.-.P.-.W.-.P
