10
-.-.G.-.-.-.P.P.-.-
-.P.-.P.-.-.-.-.-.-
-.P.-.G.-.-.-.-.P.-
-.-.-.P.-.-.-.-.-.P
-.-.-.-.-.-.-.P.P.P
G.-.-.-.P.-.P.-.G.-
-.-.-.-.-.P.-.-.-.G
G.G.P.P.-.-.W.G.-.-
P.-.P.G.-.-.-.P.P.-
-.-.-.-.-.-.-.W.-.-
