10
-.-.-.-.-.P.-.-.-.-
-.-.-.-.W.-.-.-.-.-
-.-.-.-.-.-.-.P.-.-
-.-.-.-.-.-.-.-.-.-
-.-.-.-.P.-.-.P.-.-
-.-.-.-.-.-.-.-.-.-
-.-.-.-.-.-.-.-.-.P
-.-.-.-.-.-.-.-.-.-
-.-.-.-.-.-.-.-.-.-
-.-.G.-.-.-.-.-.-.-
