10
-.W.-.-.P.-.P.-.-.-
-.P.-.-.-.W.-.-.G.-
G.W.W.-.P.W.-.-.-.-
P.-.-.-.-.-.-.-.-.-
-.W.-.-.G.-.-.G.-.-
P.-.-.-.-.-.-.-.-.-
-.-.-.W.W.-.G.-.-.P
-.-.-.P.-.-.-.-.-.-
-.-.P.W.-.-.P.P.-.-
-.-.-.P.W.G.-.-.-.-
