10
-.W.-.-.-.-.P.-.-.-
-.W.-.-.-.W.-.-.G.-
G.W.W.-.-.W.-.-.-.-
P.-.-.-.-.-.-.-.-.-
-.W.-.-.G.-.-.G.-.-
P.-.-.-.-.-.-.-.-.-
-.-.-.W.W.-.G.-.-.P
-.-.-.P.-.-.-.-.-.-
-.-.P.W.-.-.-.P.-.-
-.-.-.P.W.G.-.-.-.-
