10
P.-.-.-.P.-.P.P.P.G
W.W.W.-.P.-.-.-.-.P
-.-.P.P.-.-.-.-.-.-
-.-.-.-.W.-.G.-.P.-
-.-.-.-.P.-.-.-.-.P
G.-.-.-.P.-.P.W.-.-
G.-.P.-.G.-.-.-.P.-
-.P.P.G.-.-.P.W.-.-
-.P.-.-.-.-.-.-.-.-
-.-.-.-.P.-.-.-.W.P
