10
-.-.-.P.-.-.W.-.-.-
-.P.-.-.-.-.-.W.-.-
-.P.-.G.P.P.-.G.-.-
P.P.W.P.P.-.-.P.-.W
P.G.G.G.W.-.-.-.-.P
-.-.P.P.-.P.-.-.-.-
P.-.P.P.W.-.-.-.-.G
P.-.-.-.-.-.P.P.-.-
-.-.P.W.-.-.G.W.W.-
-.-.-.-.-.-.-.P.-.-
