10
-.-.-.P.P.-.G.-.-.-
-.-.-.-.-.-.-.-.-.-
-.-.-.-.-.-.-.-.-.-
-.-.-.-.P.-.-.-.-.-
-.-.-.W.-.-.-.-.-.P
-.-.-.-.-.-.P.-.-.-
-.-.-.-.-.-.P.-.-.-
G.-.-.-.-.P.-.-.-.-
-.-.-.-.-.-.-.-.-.-
-.-.-.-.-.-.-.-.G.-
