10
-.G.-.-.-.P.-.-.-.-
-.-.-.-.P.P.-.-.W.-
P.-.-.-.P.-.-.G.-.-
-.-.-.P.-.-.P.G.-.-
-.-.-.-.P.-.P.-.G.-
-.-.P.-.P.-.-.-.P.G
P.P.-.-.P.-.-.P.-.-
-.-.-.-.P.-.-.W.-.P
-.P.-.-.-.-.-.-.-.-
-.-.G.-.-.-.-.-.P.P
