10
W.-.-.-.P.-.P.-.P.-
-.-.-.-.P.W.P.-.-.-
-.-.-.G.W.-.-.-.P.-
-.P.P.-.G.-.-.-.P.-
P.-.-.-.P.-.-.P.-.-
-.-.-.-.-.-.P.-.-.-
-.-.P.W.-.-.-.-.-.-
-.W.-.-.-.-.-.-.-.-
P.W.-.-.-.-.-.W.P.P
P.-.-.-.-.-.P.W.-.-
