10
-.-.P.-.-.-.-.-.G.-
P.P.G.-.-.-.-.-.W.-
-.-.-.-.-.-.-.-.-.P
P.P.-.-.P.P.-.-.-.-
-.P.-.-.-.G.W.P.-.-
-.W.-.G.-.-.G.-.-.G
-.-.-.-.-.-.-.-.-.-
-.-.G.P.-.-.-.-.P.-
P.-.P.-.-.-.G.-.-.P
P.-.-.-.-.-.P.-.-.-
