10
P.-.-.W.-.-.-.P.-.-
W.-.-.-.-.-.-.-.P.P
-.-.P.P.-.-.-.-.-.-
-.-.-.-.-.-.-.-.G.P
-.P.-.W.-.P.P.W.W.P
-.-.W.W.G.-.-.-.-.-
-.P.-.-.-.P.-.-.P.-
-.W.-.-.G.P.-.-.P.P
-.-.-.P.-.W.-.-.-.-
-.-.P.-.-.-.-.G.-.-
