10
-.-.W.G.-.-.-.-.-.-
-.P.P.-.G.-.G.G.-.-
P.G.-.W.-.-.-.W.-.-
P.-.-.-.-.-.-.-.-.-
-.-.-.W.-.-.-.-.-.-
-.-.-.-.G.P.-.-.P.-
P.P.-.-.-.P.P.G.-.P
-.-.P.-.-.-.-.-.-.G
-.-.W.-.-.-.-.-.G.-
-.-.-.P.-.-.-.-.G.-
