10
-.W.-.-.P.-.-.-.P.P
-.-.-.P.P.-.P.-.G.-
P.P.-.P.-.-.-.P.-.-
P.-.G.P.-.-.-.-.P.-
P.-.-.-.-.-.P.-.-.-
-.P.-.-.-.-.-.-.-.-
-.-.-.-.-.P.P.-.-.G
-.-.-.P.-.P.-.-.-.-
-.P.-.-.-.P.P.-.-.-
-.-.-.-.W.-.-.-.-.-
