10
-.-.G.G.P.P.-.P.-.P
-.-.P.-.-.-.-.-.G.W
W.-.-.-.-.-.-.-.P.-
-.-.P.-.P.-.P.-.G.-
P.-.-.-.-.P.-.-.-.-
-.-.-.-.-.W.P.-.-.P
P.-.W.-.-.W.P.-.-.P
-.P.P.P.-.-.-.-.-.-
-.P.P.-.G.W.-.-.W.W
-.P.G.W.-.-.-.W.-.P
