10
P.-.-.-.-.-.P.W.-.P
-.-.P.P.-.-.-.P.-.P
-.-.-.-.-.W.-.-.-.P
-.-.-.-.-.P.P.-.-.-
-.-.-.P.-.-.-.-.-.-
P.-.-.P.G.-.P.W.-.-
W.P.-.-.-.-.-.-.-.-
-.P.-.P.-.P.-.-.-.P
-.P.P.-.-.P.-.-.-.P
-.-.W.P.-.P.-.-.-.P
