10
G.-.-.-.-.-.-.W.-.-
-.G.-.-.P.-.-.-.G.-
-.-.-.-.-.-.-.-.-.-
-.W.W.P.-.-.-.-.-.-
-.-.-.-.-.-.-.-.-.-
-.-.-.-.-.-.-.-.-.-
P.-.-.-.-.-.-.-.-.W
G.-.G.P.-.P.P.-.-.-
W.-.-.W.P.-.-.-.G.-
-.-.-.-.-.W.G.-.-.W
