10
-.W.W.-.-.P.P.-.-.-
W.W.-.-.P.G.-.P.-.-
P.W.-.-.-.-.-.-.-.-
P.P.G.-.P.-.-.P.-.-
G.P.-.P.-.P.-.P.-.-
W.-.P.-.-.-.W.-.-.-
-.-.G.W.-.P.P.-.-.P
-.-.-.-.-.P.-.-.-.-
-.-.-.-.P.-.-.G.-.-
-.-.-.-.P.P.-.W.-.-
