10
-.-.-.-.-.-.P.-.-.-
-.-.-.-.W.-.-.-.-.-
-.-.-.-.P.-.-.-.-.-
-.-.-.-.-.-.-.-.-.-
-.-.-.-.-.P.-.-.-.-
-.-.-.-.-.-.-.P.W.-
-.-.-.-.-.-.W.-.-.-
-.-.-.-.W.-.-.-.-.-
-.G.-.-.-.W.-.-.-.-
P.-.-.-.-.-.-.-.-.-
