10
P.-.W.W.W.P.-.P.-.P
P.P.-.-.P.P.-.P.P.-
-.-.-.-.-.P.P.-.-.W
-.P.-.P.-.G.G.-.-.P
P.-.W.-.-.P.-.-.-.P
-.P.P.-.-.-.G.-.-.P
P.-.-.-.P.G.-.G.-.P
W.-.P.G.P.P.P.P.-.-
-.-.P.P.-.P.P.-.-.P
-.G.-.-.-.-.-.-.-.G
