10
P.P.-.-.-.W.-.-.-.-
-.W.-.-.P.-.P.-.G.-
-.P.P.-.-.-.-.-.-.-
-.-.P.-.G.-.-.W.W.P
-.-.P.-.P.-.-.P.-.P
P.-.-.-.-.-.-.-.-.-
P.-.-.P.-.-.-.W.-.P
-.-.-.-.P.P.-.-.-.-
P.-.G.-.P.-.P.-.-.-
-.-.-.-.-.-.P.-.-.-
