10
-.-.-.-.-.-.-.-.P.G
-.-.P.-.W.-.-.P.-.-
-.-.-.-.-.-.G.-.-.-
G.-.-.-.-.-.G.-.-.-
-.-.-.-.-.-.-.-.-.-
-.-.W.-.-.-.-.P.G.-
-.-.-.-.-.-.-.-.-.-
-.-.-.G.P.-.G.-.-.G
-.-.P.-.-.-.-.-.P.-
-.-.-.-.-.-.-.G.W.-
