10
W.-.-.-.G.-.-.-.-.-
P.P.-.-.P.P.G.-.G.P
-.W.-.-.W.-.-.-.-.P
-.-.-.-.-.-.W.P.P.-
-.-.-.-.-.-.-.-.-.-
G.-.-.-.-.W.-.G.-.-
-.-.P.-.-.W.W.-.P.-
-.-.-.-.P.G.-.P.P.G
-.P.-.-.-.P.-.-.-.-
P.P.-.-.-.-.-.-.P.-
