10
-.W.-.-.W.-.-.-.P.-
-.W.-.P.-.-.G.P.-.-
-.W.-.-.-.-.-.P.-.W
-.-.-.P.-.-.-.-.P.P
P.-.-.-.-.W.-.-.W.-
-.-.-.-.-.-.-.G.-.-
-.-.-.-.P.-.-.-.-.-
-.-.P.-.-.-.P.-.P.-
P.-.P.-.-.P.-.-.P.-
-.-.-.-.-.-.-.-.-.-
