10
-.-.-.-.-.-.G.-.-.-
-.-.-.-.W.P.-.P.-.-
-.-.-.P.W.-.-.-.P.G
-.P.-.-.-.G.-.-.-.-
P.-.G.G.-.-.P.-.-.-
-.G.-.P.-.-.-.-.-.-
P.-.-.-.-.P.P.-.-.W
-.-.-.-.P.-.-.-.G.-
-.-.-.-.-.-.-.-.-.-
-.-.-.-.G.-.P.-.-.-
