10
-.-.-.-.-.-.-.-.P.-
-.-.-.-.W.-.P.-.-.-
-.-.-.-.-.G.-.P.P.-
-.P.-.-.-.-.W.G.-.P
P.P.-.-.-.-.P.P.-.-
-.-.-.-.-.-.P.-.P.P
P.P.-.P.P.-.-.-.G.-
-.-.-.-.-.-.-.P.-.-
-.-.P.-.-.-.-.-.-.P
P.-.-.-.W.-.W.-.W.P
