10
-.-.-.-.P.G.-.-.-.-
P.-.-.-.-.G.-.-.G.-
-.G.-.-.P.-.W.-.P.P
P.-.-.-.P.-.-.P.-.G
-.G.P.P.-.-.-.-.-.-
G.-.-.G.W.-.-.-.-.-
P.-.P.P.-.-.-.-.-.-
P.-.-.-.-.P.G.-.-.-
P.-.W.P.-.-.P.W.-.-
P.-.-.-.P.-.-.P.G.W
