10
-.P.P.-.P.P.-.-.G.-
-.-.W.G.-.-.-.-.P.-
-.P.-.-.-.-.-.-.-.-
-.-.-.-.-.P.-.P.-.-
-.-.-.-.-.-.-.P.-.-
-.-.W.-.G.-.G.-.-.P
-.W.P.G.-.-.P.-.G.-
P.G.-.-.-.-.P.-.-.-
-.-.-.G.-.P.P.G.-.-
-.-.-.P.-.-.P.G.-.-
