10
G.-.-.-.-.-.P.-.-.-
-.-.-.-.-.-.-.-.-.-
-.W.-.-.-.-.-.-.-.-
-.-.-.P.-.-.-.G.P.-
-.-.-.-.-.W.-.-.W.-
W.-.-.-.-.-.-.-.-.G
-.P.-.-.P.-.W.G.-.-
-.-.G.P.G.-.-.-.-.-
-.G.W.-.W.-.-.-.G.-
-.P.-.-.-.-.-.-.-.-
