10
-.P.G.G.-.-.-.P.-.P
-.-.-.P.-.P.P.-.P.-
-.-.P.P.G.P.-.-.P.-
-.-.P.P.-.-.-.G.-.-
P.-.-.-.-.-.P.P.-.-
P.-.-.-.P.-.-.-.-.-
P.-.-.-.-.-.-.-.-.-
-.-.-.-.-.-.P.P.P.P
-.-.-.-.P.-.-.-.-.-
-.-.P.-.W.-.-.-.-.-
