10
-.P.-.-.P.-.-.G.-.-
P.-.-.-.-.-.-.-.-.G
-.-.P.-.-.-.P.P.-.-
P.W.P.-.-.-.P.-.-.-
P.P.-.-.-.-.-.P.P.-
-.-.-.-.-.-.-.G.P.-
-.G.-.P.-.-.P.P.G.W
-.-.-.-.-.-.P.-.-.-
P.-.P.-.-.-.-.-.-.P
-.-.-.-.P.-.P.-.-.P
