10
-.-.-.-.-.-.-.-.-.G
-.-.-.-.P.-.-.P.-.-
-.-.-.-.-.-.-.-.-.W
-.-.-.-.-.-.-.G.-.-
G.-.P.G.-.-.-.-.-.P
-.G.G.-.-.-.-.-.-.-
-.-.-.-.-.-.-.P.-.-
-.-.-.-.-.-.-.-.-.-
W.-.G.-.-.-.-.-.-.G
P.-.-.-.-.-.-.-.-.-
