10
-.W.P.W.-.-.-.-.P.P
-.P.-.-.-.-.-.-.-.-
-.-.-.-.-.-.P.W.-.-
-.P.P.P.-.W.-.-.-.-
P.P.P.-.-.-.-.-.P.-
-.W.W.-.-.-.-.-.P.-
-.-.P.-.-.-.W.P.-.P
-.-.P.-.-.P.-.-.-.-
-.P.-.-.-.-.-.P.-.-
-.P.W.G.P.-.-.W.P.W
