10
-.P.-.-.P.-.-.W.P.P
-.P.G.-.-.G.P.-.-.-
-.P.P.-.G.-.P.-.-.-
P.-.-.-.-.P.P.-.P.-
-.-.-.-.-.-.-.-.-.-
-.-.-.-.-.P.-.P.-.W
W.P.P.P.-.P.G.P.P.-
-.-.-.G.W.-.-.-.G.P
P.P.-.P.-.-.W.-.-.-
-.P.P.W.-.-.G.-.-.-
