10
W.-.-.-.-.-.-.-.P.-
-.P.P.-.-.-.-.G.W.G
W.-.-.P.-.-.-.-.W.-
-.P.P.-.G.P.-.P.-.-
P.-.-.-.-.G.-.G.-.-
-.-.-.-.-.-.-.-.W.-
-.-.-.-.G.P.W.-.-.-
-.-.-.-.-.-.-.-.-.-
P.P.-.-.-.-.W.W.-.P
-.-.W.-.P.-.G.-.G.-
