10
W.-.-.P.-.P.-.-.P.-
-.P.P.-.-.-.-.G.W.G
W.-.-.-.-.-.-.-.W.-
-.P.P.-.G.-.-.-.-.-
P.-.-.-.-.G.-.G.-.-
-.-.-.-.-.-.-.-.W.-
-.-.-.-.G.P.W.-.-.-
-.-.-.-.-.-.-.-.-.-
P.P.-.-.-.-.W.W.-.P
-.-.W.-.P.-.G.-.G.-
