10
P.-.-.-.-.-.-.P.-.W
-.-.-.-.-.-.-.-.-.-
-.-.-.-.-.-.-.-.-.-
-.-.-.-.-.-.-.P.-.-
-.-.-.-.-.-.-.G.-.-
-.-.-.G.-.-.-.-.-.-
-.-.G.G.W.-.P.-.-.-
-.P.P.-.-.-.-.-.-.-
-.-.-.W.-.-.-.-.-.-
-.-.-.-.-.W.-.-.-.P
