10
-.-.-.-.-.-.-.-.-.-
-.-.-.-.-.G.-.-.P.-
-.-.W.-.-.-.-.-.-.-
-.-.-.-.G.-.-.-.-.-
-.-.-.-.-.-.-.-.-.-
-.-.-.-.-.-.-.-.-.-
-.-.-.-.-.-.-.-.-.-
-.-.-.P.-.-.-.P.-.-
-.P.P.-.-.-.-.P.-.-
-.-.-.-.-.-.-.-.-.-
