10
-.W.-.G.-.-.-.-.-.-
-.-.-.-.-.-.-.-.-.-
-.P.-.-.-.-.-.-.-.-
-.-.-.-.-.-.-.-.-.-
-.-.-.-.-.-.P.-.-.-
-.-.-.-.-.-.-.-.-.-
-.-.-.-.P.-.-.-.-.-
-.-.-.-.-.-.-.-.P.-
-.-.-.-.-.-.-.-.G.-
W.-.-.-.-.-.-.-.-.-
