10
-.-.P.-.-.-.-.-.-.-
-.W.-.-.-.-.-.-.-.W
G.-.P.-.-.-.P.P.G.-
P.-.-.-.P.G.-.-.W.-
G.-.-.-.P.P.-.-.P.-
-.P.-.-.-.-.W.-.-.P
-.-.-.-.-.-.-.-.-.-
P.-.P.-.-.-.G.P.-.-
W.-.P.P.P.G.-.-.-.-
-.-.-.-.-.-.-.W.P.P
