10
-.-.-.G.-.-.-.-.-.-
W.-.-.-.-.P.P.P.P.-
-.-.-.-.-.-.-.-.-.W
-.-.-.-.-.G.-.-.W.-
P.-.-.-.-.P.-.-.-.G
-.-.-.-.G.-.-.P.-.P
P.-.G.P.-.-.P.-.-.-
-.-.-.-.-.-.P.-.-.P
G.-.P.-.-.P.-.G.P.-
-.P.-.-.W.-.-.-.-.-
