10
-.-.-.-.G.-.G.-.-.-
-.G.-.-.-.-.-.-.W.-
-.-.-.-.-.-.-.-.P.P
W.-.G.-.P.-.P.W.-.-
W.-.P.G.-.-.P.-.-.-
-.-.-.-.-.-.-.-.P.-
-.-.-.-.-.-.P.-.-.-
-.W.W.-.-.-.-.P.-.-
-.-.-.-.-.-.-.-.P.-
-.-.-.-.-.-.-.P.W.-
