10
W.-.-.-.P.-.-.-.-.P
-.P.-.P.-.-.P.W.-.-
-.-.-.-.-.P.-.-.-.-
-.-.-.P.W.-.P.-.-.P
-.G.-.W.-.-.G.-.P.G
P.-.-.-.P.-.-.W.-.-
-.P.-.W.W.W.-.-.P.G
-.-.G.W.-.-.P.P.-.-
-.G.G.-.P.-.P.-.-.-
P.-.-.-.-.-.P.-.P.-
