10
-.-.-.-.-.W.P.W.W.-
-.P.-.W.-.-.-.-.G.-
P.-.G.-.-.-.W.P.G.G
W.-.P.-.-.-.G.-.-.-
P.P.P.-.-.-.-.-.-.-
-.-.-.-.-.-.-.-.-.-
W.-.-.G.-.P.P.-.-.-
-.-.-.-.-.G.-.W.G.-
P.G.-.P.-.-.G.P.-.P
-.-.P.-.W.-.-.-.-.-
