10
-.-.-.-.G.-.G.-.-.-
-.-.-.-.-.-.-.G.P.-
W.-.-.-.-.-.W.-.P.-
-.-.-.G.-.-.-.-.G.-
-.W.-.-.-.P.-.-.-.-
-.G.-.-.-.-.-.-.-.-
-.G.-.G.P.-.-.-.-.-
-.W.-.P.-.P.P.-.-.-
G.-.-.-.-.-.-.-.-.-
-.W.-.-.P.P.-.-.-.-
