10
-.-.-.W.-.-.-.-.-.-
-.-.-.-.-.-.-.-.-.-
-.-.-.-.-.-.-.-.P.-
-.-.-.-.-.-.-.-.-.-
-.-.-.-.-.-.-.-.P.-
-.-.-.-.-.-.-.-.G.-
-.-.-.-.-.-.-.W.-.-
-.-.-.-.G.-.-.P.W.-
-.-.-.P.-.-.-.-.-.-
-.-.-.-.-.-.-.-.-.-
