10
-.P.-.P.P.P.W.-.P.W
-.P.-.-.P.-.G.-.-.-
-.P.-.P.-.P.P.-.-.-
-.-.-.-.-.-.-.-.-.G
-.P.-.G.-.P.-.-.-.P
P.-.P.P.-.P.-.-.-.-
-.W.-.-.-.-.-.-.-.-
-.-.W.-.P.G.-.-.P.-
G.-.G.G.-.G.W.W.P.W
-.G.W.-.P.P.-.G.-.-
