10
W.P.P.-.-.-.-.-.G.-
P.-.-.-.-.-.-.-.P.-
-.-.-.W.P.G.P.-.P.-
-.-.-.-.-.-.-.P.P.-
W.-.G.P.-.-.-.P.-.-
-.-.P.-.-.-.P.-.-.-
G.-.-.P.P.P.-.P.-.-
-.-.P.P.-.G.P.G.-.-
P.P.-.-.-.P.-.W.G.-
-.-.-.-.-.-.-.-.-.-
