{
    "0": {
        "time": 0,
        "memory": 0,
        "mapSize": 10,
        "map": [
            ["-", "-", "-", "-", "-", "-", "-", "-", "B", "-"],
            ["-", "-", "S", "-", "-", "G", "-", "B", "P", "B"],
            ["-", "S", "W", "S", "-", "-", "-", "-", "B", "-"],
            ["-", "-", "S", "-", "G", "-", "-", "-", "-", "-"],
            ["-", "-", "-", "-", "-", "-", "-", "-", "-", "-"],
            ["-", "-", "-", "-", "-", "-", "-", "-", "-", "-"],
            ["-", "-", "-", "B", "-", "-", "-", "B", "-", "-"],
            ["-", "B", "B", "P", "B", "-", "B", "PB", "B", "-"],
            ["B", "PB", "PB", "B", "-", "-", "B", "PB", "B", "-"],
            ["-", "B", "B", "-", "-", "-", "-", "B", "-", "-"]
        ],
        "vision": [
            ["X", "X", "X", "X", "X", "X", "X", "X", "X", "X"],
            ["X", "X", "X", "X", "X", "X", "X", "X", "X", "X"],
            ["X", "X", "X", "X", "X", "X", "X", "X", "X", "X"],
            ["X", "X", "X", "X", "X", "X", "X", "X", "X", "X"],
            ["X", "X", "X", "X", "X", "X", "X", "X", "X", "X"],
            ["X", "X", "X", "X", "X", "X", "X", "X", "X", "X"],
            ["X", "X", "X", "X", "X", "X", "X", "X", "X", "X"],
            ["X", "X", "X", "X", "X", "X", "X", "X", "X", "X"],
            ["X", "X", "X", "X", "X", "X", "X", "X", "X", "X"],
            ["-", "X", "X", "X", "X", "X", "X", "X", "X", "X"]
        ],
        "agent": [0, 0, 0, 0]
    },
    "1": {
        "mapSize": 10,
        "map": [
            ["-", "-", "-", "-", "-", "-", "-", "-", "B", "-"],
            ["-", "-", "S", "-", "-", "G", "-", "B", "P", "B"],
            ["-", "S", "W", "S", "-", "-", "-", "-", "B", "-"],
            ["-", "-", "S", "-", "G", "-", "-", "-", "-", "-"],
            ["-", "-", "-", "-", "-", "-", "-", "-", "-", "-"],
            ["-", "-", "-", "-", "-", "-", "-", "-", "-", "-"],
            ["-", "-", "-", "B", "-", "-", "-", "B", "-", "-"],
            ["-", "B", "B", "P", "B", "-", "B", "PB", "B", "-"],
            ["B", "PB", "PB", "B", "-", "-", "B", "PB", "B", "-"],
            ["-", "B", "B", "-", "-", "-", "-", "B", "-", "-"]
        ],
        "vision": [
            ["X", "X", "X", "X", "X", "X", "X", "X", "X", "X"],
            ["X", "X", "X", "X", "X", "X", "X", "X", "X", "X"],
            ["X", "X", "X", "X", "X", "X", "X", "X", "X", "X"],
            ["X", "X", "X", "X", "X", "X", "X", "X", "X", "X"],
            ["X", "X", "X", "X", "X", "X", "X", "X", "X", "X"],
            ["X", "X", "X", "X", "X", "X", "X", "X", "X", "X"],
            ["X", "X", "X", "X", "X", "X", "X", "X", "X", "X"],
            ["X", "X", "X", "X", "X", "X", "X", "X", "X", "X"],
            ["X", "X", "X", "X", "X", "X", "X", "X", "X", "X"],
            ["-", "X", "X", "X", "X", "X", "X", "X", "X", "X"]
        ],
        "agent": [0, 0, 1, 0]
    },
    "2": {
        "mapSize": 10,
        "map": [
            ["-", "-", "-", "-", "-", "-", "-", "-", "B", "-"],
            ["-", "-", "S", "-", "-", "G", "-", "B", "P", "B"],
            ["-", "S", "W", "S", "-", "-", "-", "-", "B", "-"],
            ["-", "-", "S", "-", "G", "-", "-", "-", "-", "-"],
            ["-", "-", "-", "-", "-", "-", "-", "-", "-", "-"],
            ["-", "-", "-", "-", "-", "-", "-", "-", "-", "-"],
            ["-", "-", "-", "B", "-", "-", "-", "B", "-", "-"],
            ["-", "B", "B", "P", "B", "-", "B", "PB", "B", "-"],
            ["B", "PB", "PB", "B", "-", "-", "B", "PB", "B", "-"],
            ["-", "B", "B", "-", "-", "-", "-", "B", "-", "-"]
        ],
        "vision": [
            ["X", "X", "X", "X", "X", "X", "X", "X", "X", "X"],
            ["X", "X", "X", "X", "X", "X", "X", "X", "X", "X"],
            ["X", "X", "X", "X", "X", "X", "X", "X", "X", "X"],
            ["X", "X", "X", "X", "X", "X", "X", "X", "X", "X"],
            ["X", "X", "X", "X", "X", "X", "X", "X", "X", "X"],
            ["X", "X", "X", "X", "X", "X", "X", "X", "X", "X"],
            ["X", "X", "X", "X", "X", "X", "X", "X", "X", "X"],
            ["X", "X", "X", "X", "X", "X", "X", "X", "X", "X"],
            ["X", "X", "X", "X", "X", "X", "X", "X", "X", "X"],
            ["-", "B", "X", "X", "X", "X", "X", "X", "X", "X"]
        ],
        "agent": [0, 1, 1, -10]
    },
    "3": {
        "mapSize": 10,
        "map": [
            ["-", "-", "-", "-", "-", "-", "-", "-", "B", "-"],
            ["-", "-", "S", "-", "-", "G", "-", "B", "P", "B"],
            ["-", "S", "W", "S", "-", "-", "-", "-", "B", "-"],
            ["-", "-", "S", "-", "G", "-", "-", "-", "-", "-"],
            ["-", "-", "-", "-", "-", "-", "-", "-", "-", "-"],
            ["-", "-", "-", "-", "-", "-", "-", "-", "-", "-"],
            ["-", "-", "-", "B", "-", "-", "-", "B", "-", "-"],
            ["-", "B", "B", "P", "B", "-", "B", "PB", "B", "-"],
            ["B", "PB", "PB", "B", "-", "-", "B", "PB", "B", "-"],
            ["-", "B", "B", "-", "-", "-", "-", "B", "-", "-"]
        ],
        "vision": [
            ["X", "X", "X", "X", "X", "X", "X", "X", "X", "X"],
            ["X", "X", "X", "X", "X", "X", "X", "X", "X", "X"],
            ["X", "X", "X", "X", "X", "X", "X", "X", "X", "X"],
            ["X", "X", "X", "X", "X", "X", "X", "X", "X", "X"],
            ["X", "X", "X", "X", "X", "X", "X", "X", "X", "X"],
            ["X", "X", "X", "X", "X", "X", "X", "X", "X", "X"],
            ["X", "X", "X", "X", "X", "X", "X", "X", "X", "X"],
            ["X", "X", "X", "X", "X", "X", "X", "X", "X", "X"],
            ["X", "X", "X", "X", "X", "X", "X", "X", "X", "X"],
            ["-", "B", "X", "X", "X", "X", "X", "X", "X", "X"]
        ],
        "agent": [0, 1, 3, -10]
    },
    "4": {
        "mapSize": 10,
        "map": [
            ["-", "-", "-", "-", "-", "-", "-", "-", "B", "-"],
            ["-", "-", "S", "-", "-", "G", "-", "B", "P", "B"],
            ["-", "S", "W", "S", "-", "-", "-", "-", "B", "-"],
            ["-", "-", "S", "-", "G", "-", "-", "-", "-", "-"],
            ["-", "-", "-", "-", "-", "-", "-", "-", "-", "-"],
            ["-", "-", "-", "-", "-", "-", "-", "-", "-", "-"],
            ["-", "-", "-", "B", "-", "-", "-", "B", "-", "-"],
            ["-", "B", "B", "P", "B", "-", "B", "PB", "B", "-"],
            ["B", "PB", "PB", "B", "-", "-", "B", "PB", "B", "-"],
            ["-", "B", "B", "-", "-", "-", "-", "B", "-", "-"]
        ],
        "vision": [
            ["X", "X", "X", "X", "X", "X", "X", "X", "X", "X"],
            ["X", "X", "X", "X", "X", "X", "X", "X", "X", "X"],
            ["X", "X", "X", "X", "X", "X", "X", "X", "X", "X"],
            ["X", "X", "X", "X", "X", "X", "X", "X", "X", "X"],
            ["X", "X", "X", "X", "X", "X", "X", "X", "X", "X"],
            ["X", "X", "X", "X", "X", "X", "X", "X", "X", "X"],
            ["X", "X", "X", "X", "X", "X", "X", "X", "X", "X"],
            ["X", "X", "X", "X", "X", "X", "X", "X", "X", "X"],
            ["X", "X", "X", "X", "X", "X", "X", "X", "X", "X"],
            ["-", "B", "X", "X", "X", "X", "X", "X", "X", "X"]
        ],
        "agent": [0, 0, 3, -20]
    },
    "5": {
        "mapSize": 10,
        "map": [
            ["-", "-", "-", "-", "-", "-", "-", "-", "B", "-"],
            ["-", "-", "S", "-", "-", "G", "-", "B", "P", "B"],
            ["-", "S", "W", "S", "-", "-", "-", "-", "B", "-"],
            ["-", "-", "S", "-", "G", "-", "-", "-", "-", "-"],
            ["-", "-", "-", "-", "-", "-", "-", "-", "-", "-"],
            ["-", "-", "-", "-", "-", "-", "-", "-", "-", "-"],
            ["-", "-", "-", "B", "-", "-", "-", "B", "-", "-"],
            ["-", "B", "B", "P", "B", "-", "B", "PB", "B", "-"],
            ["B", "PB", "PB", "B", "-", "-", "B", "PB", "B", "-"],
            ["-", "B", "B", "-", "-", "-", "-", "B", "-", "-"]
        ],
        "vision": [
            ["X", "X", "X", "X", "X", "X", "X", "X", "X", "X"],
            ["X", "X", "X", "X", "X", "X", "X", "X", "X", "X"],
            ["X", "X", "X", "X", "X", "X", "X", "X", "X", "X"],
            ["X", "X", "X", "X", "X", "X", "X", "X", "X", "X"],
            ["X", "X", "X", "X", "X", "X", "X", "X", "X", "X"],
            ["X", "X", "X", "X", "X", "X", "X", "X", "X", "X"],
            ["X", "X", "X", "X", "X", "X", "X", "X", "X", "X"],
            ["X", "X", "X", "X", "X", "X", "X", "X", "X", "X"],
            ["X", "X", "X", "X", "X", "X", "X", "X", "X", "X"],
            ["-", "B", "X", "X", "X", "X", "X", "X", "X", "X"]
        ],
        "agent": [0, 0, 0, -20]
    },
    "6": {
        "mapSize": 10,
        "map": [
            ["-", "-", "-", "-", "-", "-", "-", "-", "B", "-"],
            ["-", "-", "S", "-", "-", "G", "-", "B", "P", "B"],
            ["-", "S", "W", "S", "-", "-", "-", "-", "B", "-"],
            ["-", "-", "S", "-", "G", "-", "-", "-", "-", "-"],
            ["-", "-", "-", "-", "-", "-", "-", "-", "-", "-"],
            ["-", "-", "-", "-", "-", "-", "-", "-", "-", "-"],
            ["-", "-", "-", "B", "-", "-", "-", "B", "-", "-"],
            ["-", "B", "B", "P", "B", "-", "B", "PB", "B", "-"],
            ["B", "PB", "PB", "B", "-", "-", "B", "PB", "B", "-"],
            ["-", "B", "B", "-", "-", "-", "-", "B", "-", "-"]
        ],
        "vision": [
            ["X", "X", "X", "X", "X", "X", "X", "X", "X", "X"],
            ["X", "X", "X", "X", "X", "X", "X", "X", "X", "X"],
            ["X", "X", "X", "X", "X", "X", "X", "X", "X", "X"],
            ["X", "X", "X", "X", "X", "X", "X", "X", "X", "X"],
            ["X", "X", "X", "X", "X", "X", "X", "X", "X", "X"],
            ["X", "X", "X", "X", "X", "X", "X", "X", "X", "X"],
            ["X", "X", "X", "X", "X", "X", "X", "X", "X", "X"],
            ["X", "X", "X", "X", "X", "X", "X", "X", "X", "X"],
            ["B", "X", "X", "X", "X", "X", "X", "X", "X", "X"],
            ["-", "B", "X", "X", "X", "X", "X", "X", "X", "X"]
        ],
        "agent": [1, 0, 0, -30]
    },
    "7": {
        "mapSize": 10,
        "map": [
            ["-", "-", "-", "-", "-", "-", "-", "-", "B", "-"],
            ["-", "-", "S", "-", "-", "G", "-", "B", "P", "B"],
            ["-", "S", "W", "S", "-", "-", "-", "-", "B", "-"],
            ["-", "-", "S", "-", "G", "-", "-", "-", "-", "-"],
            ["-", "-", "-", "-", "-", "-", "-", "-", "-", "-"],
            ["-", "-", "-", "-", "-", "-", "-", "-", "-", "-"],
            ["-", "-", "-", "B", "-", "-", "-", "B", "-", "-"],
            ["-", "B", "B", "P", "B", "-", "B", "PB", "B", "-"],
            ["B", "PB", "PB", "B", "-", "-", "B", "PB", "B", "-"],
            ["-", "B", "B", "-", "-", "-", "-", "B", "-", "-"]
        ],
        "vision": [
            ["X", "X", "X", "X", "X", "X", "X", "X", "X", "X"],
            ["X", "X", "X", "X", "X", "X", "X", "X", "X", "X"],
            ["X", "X", "X", "X", "X", "X", "X", "X", "X", "X"],
            ["X", "X", "X", "X", "X", "X", "X", "X", "X", "X"],
            ["X", "X", "X", "X", "X", "X", "X", "X", "X", "X"],
            ["X", "X", "X", "X", "X", "X", "X", "X", "X", "X"],
            ["X", "X", "X", "X", "X", "X", "X", "X", "X", "X"],
            ["X", "X", "X", "X", "X", "X", "X", "X", "X", "X"],
            ["B", "X", "X", "X", "X", "X", "X", "X", "X", "X"],
            ["-", "B", "X", "X", "X", "X", "X", "X", "X", "X"]
        ],
        "agent": [1, 0, 2, -30]
    },
    "8": {
        "mapSize": 10,
        "map": [
            ["-", "-", "-", "-", "-", "-", "-", "-", "B", "-"],
            ["-", "-", "S", "-", "-", "G", "-", "B", "P", "B"],
            ["-", "S", "W", "S", "-", "-", "-", "-", "B", "-"],
            ["-", "-", "S", "-", "G", "-", "-", "-", "-", "-"],
            ["-", "-", "-", "-", "-", "-", "-", "-", "-", "-"],
            ["-", "-", "-", "-", "-", "-", "-", "-", "-", "-"],
            ["-", "-", "-", "B", "-", "-", "-", "B", "-", "-"],
            ["-", "B", "B", "P", "B", "-", "B", "PB", "B", "-"],
            ["B", "PB", "PB", "B", "-", "-", "B", "PB", "B", "-"],
            ["-", "B", "B", "-", "-", "-", "-", "B", "-", "-"]
        ],
        "vision": [
            ["X", "X", "X", "X", "X", "X", "X", "X", "X", "X"],
            ["X", "X", "X", "X", "X", "X", "X", "X", "X", "X"],
            ["X", "X", "X", "X", "X", "X", "X", "X", "X", "X"],
            ["X", "X", "X", "X", "X", "X", "X", "X", "X", "X"],
            ["X", "X", "X", "X", "X", "X", "X", "X", "X", "X"],
            ["X", "X", "X", "X", "X", "X", "X", "X", "X", "X"],
            ["X", "X", "X", "X", "X", "X", "X", "X", "X", "X"],
            ["X", "X", "X", "X", "X", "X", "X", "X", "X", "X"],
            ["B", "X", "X", "X", "X", "X", "X", "X", "X", "X"],
            ["-", "B", "X", "X", "X", "X", "X", "X", "X", "X"]
        ],
        "agent": [0, 0, 2, -40]
    }
}