{
    "0": {
        "time": 0,
        "memory": 0,
        "mapSize": 10,
        "map": [
            ["-", "-", "-", "-", "S", "B", "G", "B", "-", "-"],
            ["-", "-", "-", "BS", "WBS", "PS", "B", "P", "B", "-"],
            ["-", "B", "B", "PS", "WBS", "BS", "-", "B", "P", "GB"],
            ["B", "P", "B", "B", "S", "G", "B", "-", "B", "-"],
            ["P", "B", "G", "GB", "-", "B", "P", "B", "-", "-"],
            ["B", "G", "B", "P", "B", "B", "B", "-", "-", "S"],
            ["P", "B", "-", "B", "B", "PB", "PB", "B", "S", "W"],
            ["B", "-", "-", "B", "P", "B", "B", "-", "G", "S"],
            ["-", "-", "-", "-", "B", "-", "B", "-", "-", "-"],
            ["-", "-", "-", "-", "G", "B", "P", "B", "-", "-"]
        ],
        "vision": [
            ["X", "-", "X", "X", "X", "X", "X", "X", "X", "X"],
            ["X", "X", "X", "X", "X", "X", "X", "X", "X", "X"],
            ["X", "X", "X", "X", "X", "X", "X", "X", "X", "X"],
            ["X", "X", "X", "X", "X", "X", "X", "X", "X", "X"],
            ["X", "X", "X", "X", "X", "X", "X", "X", "X", "X"],
            ["X", "X", "X", "X", "X", "X", "X", "X", "X", "X"],
            ["X", "X", "X", "X", "X", "X", "X", "X", "X", "X"],
            ["X", "X", "X", "X", "X", "X", "X", "X", "X", "X"],
            ["X", "X", "X", "X", "X", "X", "X", "X", "X", "X"],
            ["X", "X", "X", "X", "X", "X", "X", "X", "X", "X"]
        ],
        "agent": [9, 1, 0, 0]
    },
    "1": {
        "mapSize": 10,
        "map": [
            ["-", "-", "-", "-", "S", "B", "G", "B", "-", "-"],
            ["-", "-", "-", "BS", "WBS", "PS", "B", "P", "B", "-"],
            ["-", "B", "B", "PS", "WBS", "BS", "-", "B", "P", "GB"],
            ["B", "P", "B", "B", "S", "G", "B", "-", "B", "-"],
            ["P", "B", "G", "GB", "-", "B", "P", "B", "-", "-"],
            ["B", "G", "B", "P", "B", "B", "B", "-", "-", "S"],
            ["P", "B", "-", "B", "B", "PB", "PB", "B", "S", "W"],
            ["B", "-", "-", "B", "P", "B", "B", "-", "G", "S"],
            ["-", "-", "-", "-", "B", "-", "B", "-", "-", "-"],
            ["-", "-", "-", "-", "G", "B", "P", "B", "-", "-"]
        ],
        "vision": [
            ["X", "-", "X", "X", "X", "X", "X", "X", "X", "X"],
            ["X", "-", "X", "X", "X", "X", "X", "X", "X", "X"],
            ["X", "X", "X", "X", "X", "X", "X", "X", "X", "X"],
            ["X", "X", "X", "X", "X", "X", "X", "X", "X", "X"],
            ["X", "X", "X", "X", "X", "X", "X", "X", "X", "X"],
            ["X", "X", "X", "X", "X", "X", "X", "X", "X", "X"],
            ["X", "X", "X", "X", "X", "X", "X", "X", "X", "X"],
            ["X", "X", "X", "X", "X", "X", "X", "X", "X", "X"],
            ["X", "X", "X", "X", "X", "X", "X", "X", "X", "X"],
            ["X", "X", "X", "X", "X", "X", "X", "X", "X", "X"]
        ],
        "agent": [8, 1, 2, -10]
    },
    "2": {
        "mapSize": 10,
        "map": [
            ["-", "-", "-", "-", "S", "B", "G", "B", "-", "-"],
            ["-", "-", "-", "BS", "WBS", "PS", "B", "P", "B", "-"],
            ["-", "B", "B", "PS", "WBS", "BS", "-", "B", "P", "GB"],
            ["B", "P", "B", "B", "S", "G", "B", "-", "B", "-"],
            ["P", "B", "G", "GB", "-", "B", "P", "B", "-", "-"],
            ["B", "G", "B", "P", "B", "B", "B", "-", "-", "S"],
            ["P", "B", "-", "B", "B", "PB", "PB", "B", "S", "W"],
            ["B", "-", "-", "B", "P", "B", "B", "-", "G", "S"],
            ["-", "-", "-", "-", "B", "-", "B", "-", "-", "-"],
            ["-", "-", "-", "-", "G", "B", "P", "B", "-", "-"]
        ],
        "vision": [
            ["X", "-", "X", "X", "X", "X", "X", "X", "X", "X"],
            ["X", "-", "X", "X", "X", "X", "X", "X", "X", "X"],
            ["X", "B", "X", "X", "X", "X", "X", "X", "X", "X"],
            ["X", "X", "X", "X", "X", "X", "X", "X", "X", "X"],
            ["X", "X", "X", "X", "X", "X", "X", "X", "X", "X"],
            ["X", "X", "X", "X", "X", "X", "X", "X", "X", "X"],
            ["X", "X", "X", "X", "X", "X", "X", "X", "X", "X"],
            ["X", "X", "X", "X", "X", "X", "X", "X", "X", "X"],
            ["X", "X", "X", "X", "X", "X", "X", "X", "X", "X"],
            ["X", "X", "X", "X", "X", "X", "X", "X", "X", "X"]
        ],
        "agent": [7, 1, 2, -20]
    },
    "3": {
        "mapSize": 10,
        "map": [
            ["-", "-", "-", "-", "S", "B", "G", "B", "-", "-"],
            ["-", "-", "-", "BS", "WBS", "PS", "B", "P", "B", "-"],
            ["-", "B", "B", "PS", "WBS", "BS", "-", "B", "P", "GB"],
            ["B", "P", "B", "B", "S", "G", "B", "-", "B", "-"],
            ["P", "B", "G", "GB", "-", "B", "P", "B", "-", "-"],
            ["B", "G", "B", "P", "B", "B", "B", "-", "-", "S"],
            ["P", "B", "-", "B", "B", "PB", "PB", "B", "S", "W"],
            ["B", "-", "-", "B", "P", "B", "B", "-", "G", "S"],
            ["-", "-", "-", "-", "B", "-", "B", "-", "-", "-"],
            ["-", "-", "-", "-", "G", "B", "P", "B", "-", "-"]
        ],
        "vision": [
            ["X", "-", "X", "X", "X", "X", "X", "X", "X", "X"],
            ["X", "-", "X", "X", "X", "X", "X", "X", "X", "X"],
            ["X", "B", "X", "X", "X", "X", "X", "X", "X", "X"],
            ["X", "P", "X", "X", "X", "X", "X", "X", "X", "X"],
            ["X", "X", "X", "X", "X", "X", "X", "X", "X", "X"],
            ["X", "X", "X", "X", "X", "X", "X", "X", "X", "X"],
            ["X", "X", "X", "X", "X", "X", "X", "X", "X", "X"],
            ["X", "X", "X", "X", "X", "X", "X", "X", "X", "X"],
            ["X", "X", "X", "X", "X", "X", "X", "X", "X", "X"],
            ["X", "X", "X", "X", "X", "X", "X", "X", "X", "X"]
        ],
        "agent": [6, 1, 2, -10030]
    }
}