{
    "0": {
        "time": 0,
        "memory": 0,
        "mapSize": 10,
        "map": [
            ["-", "-", "-", "-", "-", "-", "-", "-", "B", "-"],
            ["-", "-", "S", "-", "-", "G", "-", "B", "P", "B"],
            ["-", "S", "W", "S", "-", "-", "-", "-", "B", "-"],
            ["-", "-", "S", "-", "G", "-", "-", "-", "-", "-"],
            ["-", "-", "-", "-", "-", "-", "-", "-", "-", "-"],
            ["-", "-", "-", "-", "-", "-", "-", "-", "-", "-"],
            ["-", "-", "-", "B", "-", "-", "-", "B", "-", "-"],
            ["-", "B", "B", "P", "B", "-", "B", "PB", "B", "-"],
            ["B", "PB", "PB", "B", "-", "-", "B", "PB", "B", "-"],
            ["-", "B", "B", "-", "-", "-", "-", "B", "-", "-"]
        ],
        "vision": [
            ["X", "X", "X", "X", "X", "X", "X", "X", "X", "X"],
            ["X", "X", "X", "X", "X", "X", "X", "X", "X", "X"],
            ["X", "X", "X", "X", "X", "X", "X", "X", "X", "X"],
            ["X", "X", "X", "X", "X", "X", "X", "X", "X", "X"],
            ["X", "X", "X", "X", "X", "X", "X", "X", "X", "X"],
            ["X", "X", "X", "X", "X", "X", "X", "X", "X", "X"],
            ["X", "X", "X", "X", "X", "X", "X", "X", "X", "X"],
            ["X", "X", "X", "X", "X", "X", "X", "X", "X", "X"],
            ["X", "X", "X", "X", "X", "X", "X", "X", "X", "X"],
            ["-", "X", "X", "X", "X", "X", "X", "X", "X", "X"]
        ],
        "agent": [0, 0, 0, 0]
    },
    "1": {
        "mapSize": 10,
        "map": [
            ["-", "-", "-", "-", "-", "-", "-", "-", "B", "-"],
            ["-", "-", "S", "-", "-", "G", "-", "B", "P", "B"],
            ["-", "S", "W", "S", "-", "-", "-", "-", "B", "-"],
            ["-", "-", "S", "-", "G", "-", "-", "-", "-", "-"],
            ["-", "-", "-", "-", "-", "-", "-", "-", "-", "-"],
            ["-", "-", "-", "-", "-", "-", "-", "-", "-", "-"],
            ["-", "-", "-", "B", "-", "-", "-", "B", "-", "-"],
            ["-", "B", "B", "P", "B", "-", "B", "PB", "B", "-"],
            ["B", "PB", "PB", "B", "-", "-", "B", "PB", "B", "-"],
            ["-", "B", "B", "-", "-", "-", "-", "B", "-", "-"]
        ],
        "vision": [
            ["X", "X", "X", "X", "X", "X", "X", "X", "X", "X"],
            ["X", "X", "X", "X", "X", "X", "X", "X", "X", "X"],
            ["X", "X", "X", "X", "X", "X", "X", "X", "X", "X"],
            ["X", "X", "X", "X", "X", "X", "X", "X", "X", "X"],
            ["X", "X", "X", "X", "X", "X", "X", "X", "X", "X"],
            ["X", "X", "X", "X", "X", "X", "X", "X", "X", "X"],
            ["X", "X", "X", "X", "X", "X", "X", "X", "X", "X"],
            ["X", "X", "X", "X", "X", "X", "X", "X", "X", "X"],
            ["X", "X", "X", "X", "X", "X", "X", "X", "X", "X"],
            ["-", "X", "X", "X", "X", "X", "X", "X", "X", "X"]
        ],
        "agent": [0, 0, 2, -10000000]
    }
}