{
    "0": {
        "time": 0,
        "memory": 0,
        "mapSize": 10,
        "map": [
            ["-", "-", "-", "-", "S", "B", "G", "B", "-", "-"],
            ["-", "-", "-", "BS", "WBS", "PS", "B", "P", "B", "-"],
            ["-", "B", "B", "PS", "WBS", "BS", "-", "B", "P", "GB"],
            ["B", "P", "B", "B", "S", "G", "B", "-", "B", "-"],
            ["P", "B", "G", "GB", "-", "B", "P", "B", "-", "-"],
            ["B", "G", "B", "P", "B", "B", "B", "-", "-", "S"],
            ["P", "B", "-", "B", "B", "PB", "PB", "B", "S", "W"],
            ["B", "-", "-", "B", "P", "B", "B", "-", "G", "S"],
            ["-", "-", "-", "-", "B", "-", "B", "-", "-", "-"],
            ["-", "-", "-", "-", "G", "B", "P", "B", "-", "-"]
        ],
        "vision": [
            ["X", "X", "X", "X", "X", "X", "X", "X", "X", "X"],
            ["X", "X", "X", "X", "X", "X", "X", "X", "X", "X"],
            ["X", "X", "X", "X", "X", "X", "X", "X", "X", "X"],
            ["X", "X", "X", "X", "X", "X", "X", "X", "X", "X"],
            ["X", "X", "X", "X", "X", "X", "X", "X", "X", "X"],
            ["X", "X", "X", "X", "X", "X", "X", "X", "X", "X"],
            ["X", "X", "X", "X", "X", "X", "X", "X", "X", "X"],
            ["X", "X", "X", "X", "X", "X", "X", "X", "X", "X"],
            ["X", "X", "X", "X", "X", "X", "X", "X", "X", "X"],
            ["X", "X", "X", "-", "X", "X", "X", "X", "X", "X"]
        ],
        "agent": [0, 3, 0, 0]
    },
    "1": {
        "mapSize": 10,
        "map": [
            ["-", "-", "-", "-", "S", "B", "G", "B", "-", "-"],
            ["-", "-", "-", "BS", "WBS", "PS", "B", "P", "B", "-"],
            ["-", "B", "B", "PS", "WBS", "BS", "-", "B", "P", "GB"],
            ["B", "P", "B", "B", "S", "G", "B", "-", "B", "-"],
            ["P", "B", "G", "GB", "-", "B", "P", "B", "-", "-"],
            ["B", "G", "B", "P", "B", "B", "B", "-", "-", "S"],
            ["P", "B", "-", "B", "B", "PB", "PB", "B", "S", "W"],
            ["B", "-", "-", "B", "P", "B", "B", "-", "G", "S"],
            ["-", "-", "-", "-", "B", "-", "B", "-", "-", "-"],
            ["-", "-", "-", "-", "G", "B", "P", "B", "-", "-"]
        ],
        "vision": [
            ["X", "X", "X", "X", "X", "X", "X", "X", "X", "X"],
            ["X", "X", "X", "X", "X", "X", "X", "X", "X", "X"],
            ["X", "X", "X", "X", "X", "X", "X", "X", "X", "X"],
            ["X", "X", "X", "X", "X", "X", "X", "X", "X", "X"],
            ["X", "X", "X", "X", "X", "X", "X", "X", "X", "X"],
            ["X", "X", "X", "X", "X", "X", "X", "X", "X", "X"],
            ["X", "X", "X", "X", "X", "X", "X", "X", "X", "X"],
            ["X", "X", "X", "X", "X", "X", "X", "X", "X", "X"],
            ["X", "X", "X", "X", "X", "X", "X", "X", "X", "X"],
            ["X", "X", "X", "-", "X", "X", "X", "X", "X", "X"]
        ],
        "agent": [0, 3, 2, -10000000]
    }
}