{
    "0": {
        "time": 0,
        "memory": 0,
        "mapSize": 10,
        "map": [
            ["-", "-", "-", "-", "S", "B", "P", "B", "-", "-"],
            ["-", "-", "-", "S", "WB", "S", "B", "-", "-", "-"],
            ["-", "-", "-", "B", "PS", "B", "-", "-", "-", "-"],
            ["-", "-", "-", "-", "B", "B", "-", "-", "-", "-"],
            ["-", "-", "-", "-", "B", "P", "B", "B", "S", "-"],
            ["-", "-", "-", "-", "-", "B", "BS", "PS", "WB", "S"],
            ["-", "-", "-", "-", "S", "S", "W", "BS", "S", "-"],
            ["-", "-", "-", "S", "W", "S", "S", "-", "-", "-"],
            ["B", "G", "-", "-", "S", "W", "S", "-", "-", "-"],
            ["P", "B", "-", "-", "-", "S", "-", "-", "-", "-"]
        ],
        "vision": [
            ["X", "X", "X", "X", "X", "X", "X", "X", "X", "X"],
            ["X", "X", "X", "X", "X", "X", "X", "X", "X", "X"],
            ["X", "X", "X", "X", "X", "X", "X", "X", "X", "X"],
            ["X", "X", "X", "X", "X", "X", "X", "X", "X", "X"],
            ["X", "X", "X", "X", "X", "X", "X", "X", "X", "X"],
            ["X", "X", "X", "X", "X", "X", "X", "X", "X", "X"],
            ["X", "X", "X", "X", "X", "X", "X", "X", "X", "X"],
            ["X", "X", "X", "X", "X", "X", "X", "X", "X", "X"],
            ["X", "X", "X", "X", "X", "X", "X", "X", "-", "X"],
            ["X", "X", "X", "X", "X", "X", "X", "X", "X", "X"]
        ],
        "agent": [1, 8, 0, 0]
    },
    "1": {
        "mapSize": 10,
        "map": [
            ["-", "-", "-", "-", "S", "B", "P", "B", "-", "-"],
            ["-", "-", "-", "S", "WB", "S", "B", "-", "-", "-"],
            ["-", "-", "-", "B", "PS", "B", "-", "-", "-", "-"],
            ["-", "-", "-", "-", "B", "B", "-", "-", "-", "-"],
            ["-", "-", "-", "-", "B", "P", "B", "B", "S", "-"],
            ["-", "-", "-", "-", "-", "B", "BS", "PS", "WB", "S"],
            ["-", "-", "-", "-", "S", "S", "W", "BS", "S", "-"],
            ["-", "-", "-", "S", "W", "S", "S", "-", "-", "-"],
            ["B", "G", "-", "-", "S", "W", "S", "-", "-", "-"],
            ["P", "B", "-", "-", "-", "S", "-", "-", "-", "-"]
        ],
        "vision": [
            ["X", "X", "X", "X", "X", "X", "X", "X", "X", "X"],
            ["X", "X", "X", "X", "X", "X", "X", "X", "X", "X"],
            ["X", "X", "X", "X", "X", "X", "X", "X", "X", "X"],
            ["X", "X", "X", "X", "X", "X", "X", "X", "X", "X"],
            ["X", "X", "X", "X", "X", "X", "X", "X", "X", "X"],
            ["X", "X", "X", "X", "X", "X", "X", "X", "X", "X"],
            ["X", "X", "X", "X", "X", "X", "X", "X", "X", "X"],
            ["X", "X", "X", "X", "X", "X", "X", "X", "X", "X"],
            ["X", "X", "X", "X", "X", "X", "X", "X", "-", "X"],
            ["X", "X", "X", "X", "X", "X", "X", "X", "-", "X"]
        ],
        "agent": [0, 8, 2, -10]
    },
    "2": {
        "mapSize": 10,
        "map": [
            ["-", "-", "-", "-", "S", "B", "P", "B", "-", "-"],
            ["-", "-", "-", "S", "WB", "S", "B", "-", "-", "-"],
            ["-", "-", "-", "B", "PS", "B", "-", "-", "-", "-"],
            ["-", "-", "-", "-", "B", "B", "-", "-", "-", "-"],
            ["-", "-", "-", "-", "B", "P", "B", "B", "S", "-"],
            ["-", "-", "-", "-", "-", "B", "BS", "PS", "WB", "S"],
            ["-", "-", "-", "-", "S", "S", "W", "BS", "S", "-"],
            ["-", "-", "-", "S", "W", "S", "S", "-", "-", "-"],
            ["B", "G", "-", "-", "S", "W", "S", "-", "-", "-"],
            ["P", "B", "-", "-", "-", "S", "-", "-", "-", "-"]
        ],
        "vision": [
            ["X", "X", "X", "X", "X", "X", "X", "X", "X", "X"],
            ["X", "X", "X", "X", "X", "X", "X", "X", "X", "X"],
            ["X", "X", "X", "X", "X", "X", "X", "X", "X", "X"],
            ["X", "X", "X", "X", "X", "X", "X", "X", "X", "X"],
            ["X", "X", "X", "X", "X", "X", "X", "X", "X", "X"],
            ["X", "X", "X", "X", "X", "X", "X", "X", "X", "X"],
            ["X", "X", "X", "X", "X", "X", "X", "X", "X", "X"],
            ["X", "X", "X", "X", "X", "X", "X", "X", "X", "X"],
            ["X", "X", "X", "X", "X", "X", "X", "X", "-", "X"],
            ["X", "X", "X", "X", "X", "X", "X", "X", "-", "X"]
        ],
        "agent": [0, 8, 2, -10000010]
    }
}